aoe 2h = age_of_empires\aoe_2h.mp3
aoe food = age_of_empires\aoe_food.mp3
aoe good king = age_of_empires\aoe_good_king.mp3
aoe king losers = age_of_empires\aoe_king_losers.mp3
aoe no = age_of_empires\aoe_no.mp3
aoe other guy = age_of_empires\aoe_other_guy.mp3
aoe raid = age_of_empires\aoe_raid.mp3
aoe start = age_of_empires\aoe_start.mp3
aoe wololo = age_of_empires\aoe_wololo.mp3
aoe yes = age_of_empires\aoe_yes.mp3
cow = animals\cow.mp3
dolphin = animals\dolphin.mp3
monkey = animals\monkey.mp3
dota aw primordial = dota\dota_aw_primordial.mp3
dota aw self = dota\dota_aw_self.mp3
dota aw unite = dota\dota_aw_unite.mp3
dota caster ams = dota\dota_caster_ams.mp3
dota caster dendi = dota\dota_caster_dendi.mp3
dota caster ding = dota\dota_caster_ding.mp3
dota caster ephey = dota\dota_caster_ephey.mp3
dota caster fogged = dota\dota_caster_fogged.mp3
dota caster lakad = dota\dota_caster_lakad.mp3
dota caster purge = dota\dota_caster_purge.mp3
dota caster slacks = dota\dota_caster_slacks.mp3
dota ck agent chaos = dota\dota_ck_agent_chaos.mp3
dota ck chaos expands = dota\dota_ck_chaos_expands.mp3
dota ck chaos reign = dota\dota_ck_chaos_reign.mp3
dota ck chaos spreads = dota\dota_ck_chaos_spreads.mp3
dota ck creation order = dota\dota_ck_creation_order.mp3
dota ck death follow = dota\dota_ck_death_follow.mp3
dota ck knight = dota\dota_ck_knight.mp3
dota ck legion comes = dota\dota_ck_legion_comes.mp3
dota cm burn body = dota\dota_cm_burn_body.mp3
dota cm ice nice = dota\dota_cm_ice_nice.mp3
dota gyro dodge this = dota\dota_gyro_dodge_this.mp3
dota gyro horse shit = dota\dota_gyro_horse_shit.mp3
dota jugg bitch = dota\dota_jugg_bitch.mp3
dota kotl shall not = dota\dota_kotl_shall_not.mp3
dota lina = dota\dota_lina.mp3
dota lina spark = dota\dota_lina_spark.mp3
dota lina world = dota\dota_lina_world.mp3
dota lion demon witch = dota\dota_lion_demon_witch.mp3
dota lion hell = dota\dota_lion_hell.mp3
dota lion strong arm = dota\dota_lion_strong_arm.mp3
dota mk king arrives = dota\dota_mk_king_arrives.mp3
dota qop hurt love = dota\dota_qop_hurt_love.mp3
dota qop long live = dota\dota_qop_long_live.mp3
dota qop pain gain = dota\dota_qop_pain_gain.mp3
dota qop resist = dota\dota_qop_resist.mp3
dota qop way = dota\dota_qop_way.mp3
dota rubick mysteries = dota\dota_rubick_mysteries.mp3
dota shaker many = dota\dota_shaker_many.mp3
dota tinker 7m = dota\dota_tinker_7m.mp3
dota tinker beams = dota\dota_tinker_beams.mp3
dota tinker pew = dota\dota_tinker_pew.mp3
dota var merp = dota\dota_var_merp.mp3
dota void history = dota\dota_void_history.mp3
dota wd feeling good = dota\dota_wd_feeling_good.mp3
dota wd look at it = dota\dota_wd_look_at_it.mp3
dota wd song = dota\dota_wd_song.mp3
c'est la guerre = kaamelott\c'est_la_guerre.mp3
c'est pas faux = kaamelott\c'est_pas_faux.mp3
details = kaamelott\details.mp3
ebaubir = kaamelott\ebaubir.mp3
faut ce qui faut = kaamelott\faut_ce_qui_faut.mp3
fleches = kaamelott\fleches.mp3
fondue = kaamelott\fondue.mp3
gros nul = kaamelott\gros_nul.mp3
gueuler comme un con = kaamelott\gueuler_comme_un_con.mp3
je vois trouble = kaamelott\je_vois_trouble.mp3
joie de vivre = kaamelott\joie_de_vivre.mp3
mais tout a fait = kaamelott\mais_tout_a_fait.mp3
merde = kaamelott\merde.mp3
pute = kaamelott\pute.mp3
reposer = kaamelott\reposer.mp3
revolte = kaamelott\revolte.mp3
volette = kaamelott\volette.mp3
matrix answered question = matrix\matrix_answered_question.mp3
matrix bourgeois = matrix\matrix_bourgeois.mp3
matrix bullet gun = matrix\matrix_bullet_gun.mp3
matrix causality = matrix\matrix_causality.mp3
matrix choice illusion = matrix\matrix_choice_illusion.mp3
matrix congratulations = matrix\matrix_congratulations.mp3
matrix dead end = matrix\matrix_dead_end.mp3
matrix deja vu = matrix\matrix_deja_vu.mp3
matrix deleted = matrix\matrix_deleted.mp3
matrix dodge this = matrix\matrix_dodge_this.mp3
matrix dreaming = matrix\matrix_dreaming.mp3
matrix end = matrix\matrix_end.mp3
matrix faster = matrix\matrix_faster.mp3
matrix for a time = matrix\matrix_for_a_time.mp3
matrix free = matrix\matrix_free.mp3
matrix free your mind = matrix\matrix_free_your_mind.mp3
matrix game = matrix\matrix_game.mp3
matrix good or bad = matrix\matrix_good_or_bad.mp3
matrix hard to believe = matrix\matrix_hard_to_believe.mp3
matrix holy shit = matrix\matrix_holy_shit.mp3
matrix human = matrix\matrix_human.mp3
matrix human being = matrix\matrix_human_being.mp3
matrix impossible = matrix\matrix_impossible.mp3
matrix interesting = matrix\matrix_interesting.mp3
matrix kungfu = matrix\matrix_kungfu.mp3
matrix not possible = matrix\matrix_not_possible.mp3
matrix prophecy lie = matrix\matrix_prophecy_lie.mp3
matrix right = matrix\matrix_right.mp3
matrix rules = matrix\matrix_rules.mp3
matrix see neo = matrix\matrix_see_neo.mp3
matrix skill = matrix\matrix_skill.mp3
matrix still here = matrix\matrix_still_here.mp3
matrix surprised = matrix\matrix_surprised.mp3
matrix truth = matrix\matrix_truth.mp3
matrix upgrades = matrix\matrix_upgrades.mp3
matrix why = matrix\matrix_why.mp3
i member = south_park\i_member.mp3
timmy = south_park\timmy.mp3
alerte au gogol = south_park_fr\alerte_au_gogol.mp3
biere = south_park_fr\biere.mp3
bonjour = south_park_fr\bonjour.mp3
donne = south_park_fr\donne.mp3
droguer = south_park_fr\droguer.mp3
infirme = south_park_fr\infirme.mp3
menace = south_park_fr\menace.mp3
mongols = south_park_fr\mongols.mp3
quua = south_park_fr\quua.mp3
ton genre = south_park_fr\ton_genre.mp3
tuer = south_park_fr\tuer.mp3
zgeg = south_park_fr\zgeg.mp3
anakin = star_wars\anakin.mp3
chewbacca = star_wars\chewbacca.mp3
done = star_wars\done.mp3
lightsaber = star_wars\lightsaber.mp3
noo = star_wars\noo.mp3
order 66 = star_wars\order_66.mp3
senate = star_wars\senate.mp3
300 sparta = various\300_sparta.mp3
ah bon = various\ah_bon.mp3
ayaya = various\ayaya.mp3
bazinga = various\bazinga.mp3
bruh = various\bruh.mp3
coffin dance = various\coffin_dance.mp3
damn = various\damn.mp3
deja vu = various\deja_vu.mp3
denis ah = various\denis_ah.mp3
discord = various\discord.mp3
dont give up = various\dont_give_up.mp3
falcon punch = various\falcon_punch.mp3
fbi open up = various\fbi_open_up.mp3
french = various\french.mp3
fucked up = various\fucked_up.mp3
gasp = various\gasp.mp3
gladiator entertained = various\gladiator_entertained.mp3
gladiator maximus = various\gladiator_maximus.mp3
hadouken = various\hadouken.mp3
hein = various\hein.mp3
here we go again = various\here_we_go_again.mp3
inconnus chasseur = various\inconnus_chasseur.mp3
inconnus que se passe = various\inconnus_que_se_passe.mp3
interessant = various\interessant.mp3
j'adore rire = various\j'adore_rire.mp3
kamehameha = various\kamehameha.mp3
laught = various\laught.mp3
lazor = various\lazor.mp3
listen = various\listen.mp3
lotr not pass = various\lotr_not_pass.mp3
msn = various\msn.mp3
msn wizz = various\msn_wizz.mp3
nani = various\nani.mp3
nope = various\nope.mp3
no god = various\no_god.mp3
nyaa = various\nyaa.mp3
oh no no = various\oh_no_no.mp3
oof = various\oof.mp3
run bitch run = various\run_bitch_run.mp3
sacrebleu = various\sacrebleu.mp3
sarko civ = various\sarko_civ.mp3
shindeiru = various\shindeiru.mp3
shut up and take my money = various\shut_up_and_take_my_money.mp3
sorry = various\sorry.mp3
steam chat = various\steam_chat.mp3
tutturu = various\tutturu.mp3
arthas darkness = warcraft\arthas_darkness.mp3
arthas over = warcraft\arthas_over.mp3
baby murloc = warcraft\baby_murloc.mp3
bwonsamdi = warcraft\bwonsamdi.mp3
bwonsamdi queen = warcraft\bwonsamdi_queen.mp3
bwonsamdi shame = warcraft\bwonsamdi_shame.mp3
denathrius humility = warcraft\denathrius_humility.mp3
drums of war = warcraft\drums_of_war.mp3
forgotten = warcraft\forgotten.mp3
for the alliance = warcraft\for_the_alliance.mp3
for the horde = warcraft\for_the_horde.mp3
frostmourne hungers = warcraft\frostmourne_hungers.mp3
furion coming = warcraft\furion_coming.mp3
garrosh answer = warcraft\garrosh_answer.mp3
garrosh challenge = warcraft\garrosh_challenge.mp3
genn cornered = warcraft\genn_cornered.mp3
illidan destiny = warcraft\illidan_destiny.mp3
illidan fate = warcraft\illidan_fate.mp3
illidan freedom = warcraft\illidan_freedom.mp3
illidan hunt = warcraft\illidan_hunt.mp3
illidan scars = warcraft\illidan_scars.mp3
khadgar done = warcraft\khadgar_done.mp3
murloc = warcraft\murloc.mp3
nzoth eyes = warcraft\nzoth_eyes.mp3
panda fight = warcraft\panda_fight.mp3
prepared = warcraft\prepared.mp3
saurfang ask = warcraft\saurfang_ask.mp3
saurfang good = warcraft\saurfang_good.mp3
saurfang hide = warcraft\saurfang_hide.mp3
sylvanas nothing = warcraft\sylvanas_nothing.mp3
sylvanas prison = warcraft\sylvanas_prison.mp3
sylvanas serve = warcraft\sylvanas_serve.mp3
thrall destiny = warcraft\thrall_destiny.mp3
thrall power = warcraft\thrall_power.mp3
times change = warcraft\times_change.mp3
velen light = warcraft\velen_light.mp3
